11111111
1C010C01
0P000111
11101011
1E001001
11111111