11111111
1C010C01
1P000111
11000011
1E000C01
11111111