1111111111111
1C0000C0000C1
1E101010101C1
1000000C00001
1010101C10101
1P000C00000C1
1010101010101
1C0000C0000C1
101C101010101
1C000000000C1
1111111111111