111111111
1010101E1
10101C101
101C10101
1P1010101
111111111
