111111111
1C01Z0C01
1P0000111
111000011
1E0010001
1110Z0001
111111111